TTTTTTTTTTTTTTT
T             T
T R           T
T   R     R   T
T              .
T P   R       T
T  R          T
T        R    T
T     R       T
T             T
TTTTTTTTTTTTTTT